{
    "pokerAmount" : 18 ,
    "mapSizeW" :  8,
    "mapSizeH" :  8,
    "pokerSize" : 2 ,
    "pokerTypeNum" : 3,
    "pokerList" : [
        [3,4,0],
        [5,4,0],
        [1,1,0],
        [3,1,0],
        [5,1,0],
        [7,1,0],
        [1,3,0],
        [3,3,0],
        [5,3,0],
        [7,3,0],
        [1,5,0],
        [3,5,0],
        [5,5,0],
        [7,5,0],
        [1,7,0],
        [3,7,0],
        [5,7,0],
        [7,7,0]
    ]
}